##############################
#    #######  ###    ##   x ##
#      ###    #####    ##    #
#   #     ##  ## ##    ##    #
#             ####         ###
#   #####        ##    ##    #
#                            #
#   ####   ####    ##        #
#   o      ##  ####  #  #    #
#   ##   ###  #####          #
#                       #    #
##############################